31 90 245 6 2 0 10
   d          d                
   d          d                
   d          d                
   d          d                
   d          d                
   d          d                
   d          d                
   d          d                
   d          d                
   d          d                
   d          d                
   d          d                
   d          d                
   d          d                
   d          d                
   d          d                
   d          d                
   c          c                
   db        bd                
   d          d                
   d          d                
   d          d                
   d          d                
   d          d                
   dd         dddddd           
    dd             dd          
     dd             dd         
      dd      d      dd        
       dd      d      dd       
        dd      d      dd      
         dd      d      dd     
          dd      d      dd    
           dd      d      dd   
            dd             dd  
             dd             dd 
              dd     d       dd
              ddb    d      bdd
             dd      d      dd 
            dd             dd  
           dd             dd   
          dd             dd    
         dd             dd     
        dd      b      dd      
       dd             dd       
      dd             dd        
     dd             dd         
    dd             dd          
   dd             dd           
  dd             dd            
 dd             dd             
dd             dd              
n       b      p               
n              p               
n              p               
n              p               
n              p               
n       u      p               
n       u      p               
n       u      p               
n       u      p               
n       u      p               
n       u      p               
n       u      p               
n       u      p               
n       u      p               
n       u      p               
n              p               
n              p               
n              p               
n              p               
n              p               
n              p               
n              p               
n              p               
n              p               
n              p               
n              p               
n              p               
n       t      p               
n              p               
n              p               
n              p               
n              p               
n              p               
n              p               
n              p               
n              p               
n              p               
n              p               
n              p               
3 17 0 
14 17 180 
4 18 90 
13 18 90 
16 36 0 
28 36 180 
16 42 45
8 51 45 