40 100 242 8 5 8 71
                 hmmmmmmmmmmmme         
                 r            r         
                 r            r         
                 r            r         
                 r            r         
                 r            r         
                 r   uuu      r         
                 r   vvv      r         
                 r   xxx    s r         
                 r   wwx      r         
                 r    ww      r         
                 r            r         
                 j            j         
                ds           d          
               d       c    d           
              d            d            
             d            d             
            d            d              
           d  ww        d               
          d   ww       d                
         d    ww      d                 
        d            d                  
       d            d                   
      d   b        d                    
     d            d                     
    d              d                    
   d                d                   
  d      x           d                  
 d                s   d                 
d                      d                
 d                      d               
  d         w            d              
   d       wxw            d             
    d       w              d            
     d                      d           
      d              xxb     d          
       d             xx       d         
        d                      d        
         d                      d       
          d                      d      
           d                      d     
            d                wwb   d    
             d               ww     d   
              d   s                  d  
               d                      d 
                d                      d
                 d                    d 
                d                    d  
               d                    d   
              d      ww            d    
             d       ww      c    d     
            d        ww          d      
           d                    d       
          d                    d        
         d                    d         
        d                    d          
       d  s                 d           
      d         w          d            
     d         wxw        d             
    d           w b      d              
   d         c          d               
  d                    d                
 d     v              d                 
d   b vwv            d                  
 d     v              d                 
  d                    d                
   d                   sd               
    d           vv       d              
     d          vv        d             
      d         vv         d            
       d                    d           
        d                    d          
         d                    d         
          d           u       cd        
           d    b    uvu        d       
            d         u          d      
             d                    d     
              d                    d    
               d                    d   
                d                    d  
                 d         u          d 
                  d       uvu     c    d
                 d         ub         d 
                d                    d  
               d                    d   
              d                    d    
             d                    d     
            d                    d      
           d                    d       
          d       u            d        
         d   b   uuu       s  d         
        d         u          d          
       d                    d           
      d                    d            
     d   s                d             
    d                    d              
   d        l  t  l     d               
  d         pe   hn    d                
 l          pn   pn   l                 
 gqqqqqqqqqqooqqqooqqqf                 
23 14 225 
10 23 45 
23 35 180 
31 41 180 
29 50 180 
18 59 90 
13 60 45 
4 63 0 
30 73 180 
16 74 90 
34 81 180 
28 82 135 
13 90 0 
